Copy letters
-- HUMAN RESOURCE MACHINE PROGRAM --

    JUMP     c
    JUMP     b
    JUMP     a
a:
b:
c:
    COPYFROM 4
    OUTBOX  
    COPYFROM 0
    COPYFROM 0
    COPYFROM 0
    COPYFROM 0
    COPYFROM 0
    COPYFROM 0
    COPYFROM 0
    COPYFROM 0
    COPYFROM 0
    COPYFROM 0
    COPYFROM 0
    COPYFROM 0
    COPYFROM 0
    COPYFROM 0
    COPYFROM 0
    COPYFROM 0
    COPYFROM 0
    COPYFROM 0
    COPYFROM 0
    OUTBOX  
    COPYFROM 3
    OUTBOX  



